Underwater
45
180
SSSSSSSSSSSSSSSSSSSSSSSSSSSSSSSSSSSSSSSS
SBTTTTTBBTTTTTTTBTPBRTTTTTTTBTTTTTTTTBTS
STTTTTBTBTTTTTTTTTTTTBTTTTBTTBTBTTTTTTTS
STTTTTTTTBTTBTTTTTTTTTTTTTTBTTTTTTTTTTTS
STTTTTTTTLTTTTTTTTTTTBTTTTTBBTTBTTTTTTTS
SBTTTTTTTTBTTTTTBTTTBTTTTTTTBTTBTTTTTTTS
STBTTBTTTTTTTTBTTTTTTBTBBTTTTTTTTTBTTTTS
STTBTTTTTBTTTTTTTTTTTBTBBTTTTTTTTTBTTTBS
STTTTTTTTTTTTTBTBTTTTBTTBTTTTTTTTBTTBTTS
SBTBTTTTTTTTTTBTBTTTTTTTTTTBTTTTTTTTTTTS
STTTTTTTTTTBBTBTTBTTTTBTTTBTTTTBTTBTBTTS
STTTTTTTTTTBTTBTTBTTTTTTTTTTTBTTTTTBTTTS
STTTBTBTTTTTTTBTTTTTTTTTTTBTTTTTTTTBTTTS
STTTBTBTTTBTTTTTTTTBTTTTTTTBTTTTTTTTTTTS
STTTTBTBTTBTTTTTTTTBTTTTTBTTTTTTTTTTTTBS
STTTTTTBTTTTBTTTTBTTBTBTTTTTTBTTTTTTTTTS
STTBTTTTTTTTTSSSSSSSSSSSSSSTTTTTTTTTTTTS
STTBTTTTTTTTTRRRRRRRRRRRRRRTTTTTTTTTTTTS
SBTTTTTTTTTTTBBBBBBBBBBBBBBTTTTTTTTTBTTS
STTTTTTTTTTTTTTTTTTTTTTTTTTTTTTTTTTTTTTS
STBTTTTTTTTTTTTTTTTTTTTTTTTTTTTTTTTBTTTS
SSSSSSSSSSSSSSSSSSSSSSSSSSSSSSSSSSSSSSSS
